1,1,9,6,4,9
8,5,4,8,1,1
7,7,1,8,3,4
6,9,1,5,3,5
8,7,6,8,9,2
9,7,6,7,6,6
32,15,11,26,19,22 
21,13,20,11,26,34