5,9,4,6,1
6,2,3,6,7
3,4,8,4,4
2,2,6,4,6
7,3,1,6,5
8,11,13,18,22
24,13,15,8,12