15,11,18,15,17,19,15,11,18
18,16,15,11,18,17,14,13,15
12,15,14,17,17,16,14,11,17
12,11,15,14,16,11,18,16,13
17,16,18,18,13,16,11,18,11
13,19,18,18,17,13,15,17,12
17,11,19,16,19,17,12,11,12
16,11,19,11,19,19,17,14,19
16,15,17,18,15,13,13,14,11
104,106,35,127,32,106,28,114,54
73,78,58,77,68,78,84,71,119