5,4,2,6,7,1,3
2,5,3,6,1,7,4
2,4,1,5,7,3,6
1,2,3,4,5,6,7
7,6,5,4,3,2,1
4,3,5,7,6,2,1
3,2,7,6,5,4,1
11,26,16,38,33,21,22
21,25,25,27,27,28,14