5,9,4,6,1
6,2,3,6,7
3,4,8,4,4
2,2,6,4,6
7,3,1,6,5
5,9,13,26,22
24,13,16,10,12