6,4,2,5,6,7
8,5,2,9,8,3
5,3,6,7,7,5
4,2,6,4,7,8
4,6,9,1,2,4
5,3,7,5,2,3
28,13,15,12,25,23
23,21,27,22,9,14