1,4,1,2,3,2,2
2,3,2,1,1,4,2
2,2,3,2,3,3,4
3,1,3,2,2,2,2
3,4,1,4,2,4,2
1,4,1,1,2,4,3
3,3,4,3,2,1,4
12,17,11,8,3,3,17
8,6,14,10,14,5,14